12 17 
#################
#    $#    B    #
#  B $# ****A** # 
#    $# ******* # 
#    $#         #
#$$$ $# #### #### 
#### ##    #P#  # 
#  # # C   ###  #
#      C        # 
#$$$$$$$$$$$$$$$# 
#***************#
#################