12 18
##################
#    $#          #
#    $#C****A*** # 
#    $# ******** # 
#    $#          #
#$$$ $# #### ### # 
#### ##    #P#   # 
#  # #     ###   #
#                # 
#$$$$$$$$$$$$$$$$# 
#****************#
##################